AAAAAAAAAAAAAAAAAAAAAAAAAAAAAAAAAAAAAAAAAAAAAAAAAAAAAAAAAAAAAAAAAAAA
AAAAAAAAAAAAAAAAAAAAAAAAAAAAAAAAAAAAAAAAAAAAAAAAAAAAAAAAAAAAAAAAAAAA
AAAAAAAAAAAAAAAAAAAAAAAAAAAAAAAAAAAAAAAAAAAAAAAAAAAAAAAAAAAAAAAAAAAA
AAAAAAAAAAAAAAAAAAAAAAAAAAAAAAAAAAAAAAAAAAAAAAAAAAAAAAAAAAAAAAAAAAAA
AAAA............................................................AAAA
AAAA............................................................AAAA
AAAA............................................................AAAA
AAAA............................................................AAAA
AAAA............................................................AAAA
AAAA............................................................AAAA
AAAA............................................................AAAA
AAAA............................................................AAAA
AAAA............................................................AAAA
AAAA............................................................AAAA
AAAA............................................................AAAA
AAAA............................................................AAAA
AAAA............................................................AAAA
AAAA............................................................AAAA
AAAA............................................................AAAA
AAAA............................................................AAAA
AAAA............................................................AAAA
AAAA............................................................AAAA
AAAA............................................................AAAA
AAAA............................................................AAAA
AAAA............................................................AAAA
AAAA............................................................AAAA
AAAA............................................................AAAA
AAAA............................................................AAAA
AAAA............................................................AAAA
AAAA............................................................AAAA
AAAA............................................................AAAA
AAAA............................................................AAAA
AAAA............................................................AAAA
AAAA............................................................AAAA
AAAA............................................................AAAA
AAAA............................................................AAAA
AAAA............................................................AAAA
AAAA............................................................AAAA
AAAA............................................................AAAA
AAAA............................................................AAAA
AAAA............................................................AAAA
AAAA............................................................AAAA
AAAA............................................................AAAA
AAAA............................................................AAAA
AAAA............................................................AAAA
AAAA............................................................AAAA
AAAA............................................................AAAA
AAAA............................................................AAAA
AAAA............................................................AAAA
AAAA............................................................AAAA
AAAA............................................................AAAA
AAAA............................................................AAAA
AAAA............................................................AAAA
AAAA............................................................AAAA
AAAA............................................................AAAA
AAAA............................................................AAAA
AAAA........................................AAAA........AAAAAAAAAAAA
AAAA........................................AAAA........AAAAAAAAAAAA
AAAA....................................AAAAAAAA........AA......AAAA
AAAA....................................AAAAAAAA........AA......AAAA
AAAA..................................AAAA....AA........AA......AAAA
AAAA..................................AAAA....AA........AA......AAAA
AAAA..................................AA......AA........AA......AAAA
AAAA..................................AA......AA........AA......AAAA
AAAA................................AAAA......AA........AA......AAAA
AAAA................................AAAA......AA........AA......AAAA
AAAA..............................AAAA........AA........AA......AAAA
AAAA..............................AAAA........AA........AA......AAAA
AAAA............................AAAA..........AA........AA......AAAA
AAAA............................AAAA..........AA........AA......AAAA
AAAA............................AA............AA........AA......AAAA
AAAA............................AA............AA........AA......AAAA
AAAA..........................AAAA............AA........AAAAAA..AAAA
AAAA..........................AAAA............AA........AAAAAA..AAAA
AAAA..........................AA............AA............AAAA..AAAA
AAAA..........................AA............AA............AAAA..AAAA
AAAA........................AAAA..........AA................AAAAAAAA
AAAA........................AAAA..........AA................AAAAAAAA
AAAA....................AAAAAA..........AAAA....................AAAA
AAAA....................AAAAAA..........AAAA....................AAAA
AAAA..................AAAA..........AAAAAA......................AAAA
AAAA..................AAAA..........AAAAAA......................AAAA
AAAAAAAAAA........AAAAAA............AAAA........................AAAA
AAAAAAAAAA........AAAAAA............AAAA........................AAAA
AAAA....AA........AA..............AAAA..........................AAAA
AAAA....AA........AA..............AAAA..........................AAAA
AAAA....AA........AA..............AA............................AAAA
AAAA....AA........AA..............AA............................AAAA
AAAA....AA........AA............AAAA............................AAAA
AAAA....AA........AA............AAAA............................AAAA
AAAA....AA........AA..........AAAA..............................AAAA
AAAA....AA........AA..........AAAA..............................AAAA
AAAA....AA........AA........AAAA................................AAAA
AAAA....AA........AA........AAAA................................AAAA
AAAA....AA........AA......AAAAAA................................AAAA
AAAA....AA........AA......AAAAAA................................AAAA
AAAAAAAAAA........AA......AAAA..................................AAAA
AAAAAAAAAA........AA......AAAA..................................AAAA
AAAA....AA........AA....AAAA....................................AAAA
AAAA....AA........AA....AAAA....................................AAAA
AAAAAAAAAA........AAAAAAAAAA....................................AAAA
AAAAAAAAAA........AAAAAAAAAA....................................AAAA
AAAA..............AAAAAAAAAA....................................AAAA
AAAA..............AAAAAAAAAA....................................AAAA
AAAA............................................................AAAA
AAAA............................................................AAAA
AAAA............................................................AAAA
AAAA............................................................AAAA
AAAA............................................................AAAA
AAAA............................................................AAAA
AAAA............................................................AAAA
AAAA............................................................AAAA
AAAA............................................................AAAA
AAAA............................................................AAAA
AAAA............................................................AAAA
AAAA............................................................AAAA
AAAA............................................................AAAA
AAAA............................................................AAAA
AAAA............................................................AAAA
AAAA............................................................AAAA
AAAA............................................................AAAA
AAAA............................................................AAAA
AAAA............................................................AAAA
AAAA............................................................AAAA
AAAA............................................................AAAA
AAAA............................................................AAAA
AAAA............................................................AAAA
AAAA............................................................AAAA
AAAA............................................................AAAA
AAAA............................................................AAAA
AAAA............................................................AAAA
AAAA............................................................AAAA
AAAA............................................................AAAA
AAAA............................................................AAAA
AAAA............................................................AAAA
AAAA............................................................AAAA
AAAA............................................................AAAA
AAAA............................................................AAAA
AAAA............................................................AAAA
AAAA............................................................AAAA
AAAA............................................................AAAA
AAAA............................................................AAAA
AAAA............................................................AAAA
AAAA............................................................AAAA
AAAA............................................................AAAA
AAAA............................................................AAAA
AAAA............................................................AAAA
AAAA............................................................AAAA
AAAA............................................................AAAA
AAAA............................................................AAAA
AAAA............................................................AAAA
AAAA............................................................AAAA
AAAA............................................................AAAA
AAAA............................................................AAAA
AAAAAAAAAAAAAAAAAAAAAAAAAAAAAAAAAAAAAAAAAAAAAAAAAAAAAAAAAAAAAAAAAAAA
AAAAAAAAAAAAAAAAAAAAAAAAAAAAAAAAAAAAAAAAAAAAAAAAAAAAAAAAAAAAAAAAAAAA
AAAAAAAAAAAAAAAAAAAAAAAAAAAAAAAAAAAAAAAAAAAAAAAAAAAAAAAAAAAAAAAAAAAA
AAAAAAAAAAAAAAAAAAAAAAAAAAAAAAAAAAAAAAAAAAAAAAAAAAAAAAAAAAAAAAAAAAAA
