AAAAAAAAAAAAAAAAAAAAAAAAAAAAAAAAAAAAAAAAAAAAAAAAAAAAAAAAAAAAAAAAAAAA
AAAAAAAAAAAAAAAAAAAAAAAAAAAAAAAAAAAAAAAAAAAAAAAAAAAAAAAAAAAAAAAAAAAA
AAAAAAAAAAAAAAAAAAAAAAAAAAAAAAAAAAAAAAAAAAAAAAAAAAAAAAAAAAAAAAAAAAAA
AAAAAAAAAAAAAAAAAAAAAAAAAAAAAAAAAAAAAAAAAAAAAAAAAAAAAAAAAAAAAAAAAAAA
AAAA............................................................AAAA
AAAA............................................................AAAA
AAAA............................................................AAAA
AAAA............................................................AAAA
AAAA............................................................AAAA
AAAA............................................................AAAA
AAAA............................................................AAAA
AAAA............................................................AAAA
AAAA............................................................AAAA
AAAA............................................................AAAA
AAAA............................................................AAAA
AAAA............................................................AAAA
AAAA............................................................AAAA
AAAA............................................................AAAA
AAAA............................................................AAAA
AAAA............................................................AAAA
AAAA............................................................AAAA
AAAA............................................................AAAA
AAAA............................................................AAAA
AAAA............................................................AAAA
AAAA............................................................AAAA
AAAA............................................................AAAA
AAAA............................................................AAAA
AAAA............................................................AAAA
AAAA............................................................AAAA
AAAA............................................................AAAA
AAAA............................................................AAAA
AAAA............................................................AAAA
AAAA............................................................AAAA
AAAA............................................................AAAA
AAAA............................................................AAAA
AAAA............................................................AAAA
AAAA............................................................AAAA
AAAA............................................................AAAA
AAAA............................................................AAAA
AAAA............................................................AAAA
AAAA............................................................AAAA
AAAA............................................................AAAA
AAAA............................................................AAAA
AAAA............................................................AAAA
AAAA............................................................AAAA
AAAA............................................................AAAA
AAAA............................................................AAAA
AAAA............................................................AAAA
AAAA............................................................AAAA
AAAA............................................................AAAA
AAAA............................................................AAAA
AAAA............................................................AAAA
AAAA............................................................AAAA
AAAA............................................................AAAA
AAAA............................................................AAAA
AAAA............................................................AAAA
AAAA..................................AAAAAAA..............AAAAAAAAA
AAAA.................................AAAAAAAAA...........AAAAAAAAAAA
AAAA................................AAAAAAAAAAAA........AAAAAAAAAAAA
AAAA................................AAAAAAAAAAAA........AAAAAAAAAAAA
AAAA...............................AAAAAAAAAAAAA........AAAAAAAAAAAA
AAAA..............................AAAAAAAAAAAAAA........AAAAAAAAAAAA
AAAA.............................AAAAAAAAAAAAAAA........AAAAAAAAAAAA
AAAA............................AAAAAAAAAAAAAAAA........AAAAAAAAAAAA
AAAA............................AAAAAAAAAAAAAAAA........AAAAAAAAAAAA
AAAA...........................AAAAAAAAAAAAAAAAA........AAAAAAAAAAAA
AAAA..........................AAAAAAAAAAAAAAAAAA........AAAAAAAAAAAA
AAAA..........................AAAAAAAAAAAAAAAAAA........AAAAAAAAAAAA
AAAA.........................AAAAAAAAAAAAAAAAAAA........AAAAAAAAAAAA
AAAA.........................AAAAAAAAAAAAAAAAAAA........AAAAAAAAAAAA
AAAA........................AAAAAAAAAAAAAAAAAAAA........AAAAAAAAAAAA
AAAA........................AAAAAAAAAAAAAAAAAAAA........AAAAAAAAAAAA
AAAA.......................AAAAAAAAAAAAAAAAAAAAA........AAAAAAAAAAAA
AAAA......................AAAAAAAAAAAAAAAAAAAAAA.........AAAAAAAAAAA
AAAA.....................AAAAAAAAAAAAAAAAAAAAAAA..........AAAAAAAAAA
AAAA....................AAAAAAAAAAAAAAAAAAAAAAA...........AAAAAAAAAA
AAAA...................AAAAAAAAAAAAAAAAAAAAAAA.............AAAAAAAAA
AAAA..................AAAAAAAAAAAAAAAAAAAAAAAA..............AAAAAAAA
AAAA.................AAAAAAAAAAAAAAAAAAAAAAAA...................AAAA
AAAA................AAAAAAAAAAAAAAAAAAAAAAAA....................AAAA
AAAA...............AAAAAAAAAAAAAAAAAAAAAAAAA....................AAAA
AAAA...............AAAAAAAAAAAAAAAAAAAAAAAA.....................AAAA
AAAA..............AAAAAAAAAAAAAAAAAAAAAAAAA.....................AAAA
AAAAAAAA..........AAAAAAAAAAAAAAAAAAAAAAAA......................AAAA
AAAAAAAAA.........AAAAAAAAAAAAAAAAAAAAAAA.......................AAAA
AAAAAAAAAA........AAAAAAAAAAAAAAAAAAAAAAA.......................AAAA
AAAAAAAAAA........AAAAAAAAAAAAAAAAAAAAAA........................AAAA
AAAAAAAAAA........AAAAAAAAAAAAAAAAAAAAA.........................AAAA
AAAAAAAAAA........AAAAAAAAAAAAAAAAAAAAA.........................AAAA
AAAAAAAAAA........AAAAAAAAAAAAAAAAAAAA..........................AAAA
AAAAAAAAAA........AAAAAAAAAAAAAAAAAAA...........................AAAA
AAAAAAAAAA........AAAAAAAAAAAAAAAAAA............................AAAA
AAAAAAAAAA........AAAAAAAAAAAAAAAAAA............................AAAA
AAAAAAAAAA........AAAAAAAAAAAAAAAAA.............................AAAA
AAAAAAAAAA........AAAAAAAAAAAAAAAAA.............................AAAA
AAAAAAAAAA........AAAAAAAAAAAAAAAA..............................AAAA
AAAAAAAAAA........AAAAAAAAAAAAAAA...............................AAAA
AAAAAAAAAA........AAAAAAAAAAAAAA................................AAAA
AAAAAAAAAA........AAAAAAAAAAAAA.................................AAAA
AAAAAAAAA.........AAAAAAAAAAAA..................................AAAA
AAAAAAAA...........AAAAAAAAAAA..................................AAAA
AAAAAAA............AAAAAAAAAA...................................AAAA
AAAA................AAAAAAAA....................................AAAA
AAAA.................AAAAAA.....................................AAAA
AAAA............................................................AAAA
AAAA............................................................AAAA
AAAA............................................................AAAA
AAAA............................................................AAAA
AAAA............................................................AAAA
AAAA............................................................AAAA
AAAA............................................................AAAA
AAAA............................................................AAAA
AAAA............................................................AAAA
AAAA............................................................AAAA
AAAA............................................................AAAA
AAAA............................................................AAAA
AAAA............................................................AAAA
AAAA............................................................AAAA
AAAA............................................................AAAA
AAAA............................................................AAAA
AAAA............................................................AAAA
AAAA............................................................AAAA
AAAA............................................................AAAA
AAAA............................................................AAAA
AAAA............................................................AAAA
AAAA............................................................AAAA
AAAA............................................................AAAA
AAAA............................................................AAAA
AAAA............................................................AAAA
AAAA............................................................AAAA
AAAA............................................................AAAA
AAAA............................................................AAAA
AAAA............................................................AAAA
AAAA............................................................AAAA
AAAA............................................................AAAA
AAAA............................................................AAAA
AAAA............................................................AAAA
AAAA............................................................AAAA
AAAA............................................................AAAA
AAAA............................................................AAAA
AAAA............................................................AAAA
AAAA............................................................AAAA
AAAA............................................................AAAA
AAAA............................................................AAAA
AAAA............................................................AAAA
AAAA............................................................AAAA
AAAA............................................................AAAA
AAAA............................................................AAAA
AAAA............................................................AAAA
AAAA............................................................AAAA
AAAA............................................................AAAA
AAAA............................................................AAAA
AAAA............................................................AAAA
AAAA............................................................AAAA
AAAAAAAAAAAAAAAAAAAAAAAAAAAAAAAAAAAAAAAAAAAAAAAAAAAAAAAAAAAAAAAAAAAA
AAAAAAAAAAAAAAAAAAAAAAAAAAAAAAAAAAAAAAAAAAAAAAAAAAAAAAAAAAAAAAAAAAAA
AAAAAAAAAAAAAAAAAAAAAAAAAAAAAAAAAAAAAAAAAAAAAAAAAAAAAAAAAAAAAAAAAAAA
AAAAAAAAAAAAAAAAAAAAAAAAAAAAAAAAAAAAAAAAAAAAAAAAAAAAAAAAAAAAAAAAAAAA
