AAAAAAAAAAAAAAAAA
A...............A
A...............A
A...............A
A...............A
A...............A
A...............A
A...............A
A...............A
A...............A
A...............A
A...............A
A...............A
A...............A
A...............A
A...............A
A...............A
AAAAAAAAAAA.AAAAA
A...............A
A...............A
A...............A
A...............A
A...............A
A...............A
A...............A
A...............A
A...............A
A...............A
A...............A
A...............A
A...............A
A...............A
A...............A
A...............A
A...............A
A...............A
A...............A
A...............A
AAAAAAAAAAAAAAAAA
