AAAAAAAAAAAAAAAAAAAAAAAAAAAAAAAAA
A...............................A
A...............................A
A...............................A
A...............................A
A...............................A
A...............................A
A...............................A
A...............................A
A...............................A
A...............................A
A...............................A
A...............................A
A...............................A
A...............................A
A...............................A
A...............................A
A...............................A
A...............................A
A...............................A
A...............................A
A...............................A
A...............................A
A...............................A
A...............................A
A...............................A
AAAAAAAAAAAAAAAAAAA..AAAAAAAAAAAA
A...............................A
A...............................A
A...............................A
A...............................A
A...............................A
A...............................A
A...............................A
A...............................A
A...............................A
A...............................A
A...............................A
A...............................A
A...............................A
A...............................A
A...............................A
A...............................A
A...............................A
A...............................A
A...............................A
A...............................A
A...............................A
A...............................A
A...............................A
A...............................A
A...............................A
A...............................A
A...............................A
A...............................A
A...............................A
A...............................A
A...............................A
A...............................A
A...............................A
A...............................A
A...............................A
A...............................A
A...............................A
A...............................A
A...............................A
A...............................A
A...............................A
A...............................A
A...............................A
A...............................A
A...............................A
A...............................A
A...............................A
A...............................A
A...............................A
A...............................A
AAAAAAAAAAAAAAAAAAAAAAAAAAAAAAAAA
